XXXXXXXXXXXXXXXXXXXX
X          XXX     X
X XX XX XXX    XXX X
X X   XXXXX XXX    X
X   X     X XXX XXXX
X XXXX XX   XXX  X X
XXX    X  XXXXXX X X
X   XXXXX XX     X Z
X XXXXXXX   XXXXXX X
X XXXXXXXXX  XXXXX X
X XXXXXXXXXX XXXXX X
X XX    X     X    X
X  X XX X XXX X XXXX
X XX  X   XXX X  XXX
X XX XXXX XX XXX XXX
X XX   SX X   XX XXX
X X XXXXX X X  X   X
X    XX X X XX XXX X
XX X        XX     X
XXXXXXXXXXXXXXXXXXXX
