XXXXXXXXXXXXXXXXXXXXXXXXXXXXXXXXXXXXXXXXXXXXXXXXXX
X         X   XX XX   XX      XXXXX X XXXXX      X
X X X XXXXX X  X    X    X XX X   X X XXXXX XXXX X
X X XXX     XX  XXX XXXXXXX   X X X X XXX   XXXS X
XX    X XXXXXXX     XXXXX   XXX X X X     XXXXXXXX
X  XX XXX    XX XXXXXXXX  XXXXX X   XXXXX XX     X
X XXX     XX     XXXXXXX XX   X XXXXXXXXX  X XX XX
X XXXXXXXXXXXXXX XXXXXXXXXX X   XXXXXXXXXX X XX XX
X XXXXXXX X  X X  XXXX XX   XXX XXXXXXXXX  X XX XX
X XXX     XX   XX   X   X X X X  XXXXXXXX XX X  XX
X  XX X X X  X XXXX XXX X X    X XX     X XXX  XXX
XX XX XXX X XX XX   XX  X XXXX X    XXX X  XX XXXX
XX      X   XXX X X    XX XX   XX XXXXX XX  X XXXX
XXXXXXX  XX XXX   XXXXX   X  XXX  X   X  XX   XXXX
X  X   X  X   XXXXX   XXXXX XXXX XXXX XX X  XXXXXX
XX  XX XX XXX  XX   X X   X   XX  X   XX   XX XXXX
XXX  X    XXXX XX XXXXX X   X  XX   X X X X X XXXX
X   XX XX   XX    X   X XX XXX  XXXXX X X X X  XXX
X X    XXXX  XX XX  X   X  X XX  XXX  X X X  X XXX
X XXXXX    X X  XX XXXXXXX X XXX  XX XX X XX X   X
X     X XX X X XXX X   XXX X XXXX  X    X XX XXX X
X X X XXX    X   X  XX   XXX    X XXXXXXX     X  X
X X X     XXX XXXXX    X   X XX X X XX   XXXX   XX
X X XXXXX      X  XXXXXXX XX  X X X X  X  XXXXXXXX
X   X   X XX X XX    XXXX XX XXX  X XX XX      XXX
X XXX XXX XX X  X XX  XXX  X X X X  XX XXXXXXX   X
X   X   X X  XX X X X XXXX X     X XX  X      XX X
XXX   X X XXXXX X X X      XXXX XX XX XX XX X XX X
XXXXXXX X   XX  X    XXXXXXXXXX XX XX  X XX X  X X
XXXXXX   XX X  XXXXX XXXXXXXXXX    XXX  XX   X X X
XXXXXX X X  XX   XX  XXXXXXXXXXXXXX    X   X X X X
XXX    X XXX X X    XXXXXXXXXXXXXXX XXXXXXXX  XX X
XX  XXXX   X X XXXXXXXXXXXXXXXXXXXX X      XX X  X
X  XXXXXXXX    X XXXXXXXXXXXXXXXXXX X XXXX X  X XX
X XXXXXXX   XXX    X    XXXXXXXXX   X XXXX   XX XX
X  XXXXX  X     XX   XX XXXXXXX   XXX    XXXXXX XX
XX   XXX XXXXXX  X XXXX XXXXXXX X  XX XX   X  X  X
X  XX    X     X XX   X   XX    XX X     X X XXX X
X XXX XXXX X XXX XX X XXX X  XXXXX   XXXXX     X Z
X XXX XX X X XX  XX XXXXX XX  X   XXXXXXXXX XX XXX
X XXX  X   X  X XXX X   X   X   X  X     XX  X  XX
X  XXX XXXX  XX     X X XXX XXXXXX XX XX XXXXXX XX
XXXXXX XX   X X XXX X X  XX   XX X  X X  XXXX   XX
X XX   X  X X X     X XX   XX  X XX   XX XXX  XXXX
X X  XXXXXX X XXXXXX  XXXX XXX X XX X X  XX  XXXXX
X X X   XXX X X X XX XXXXX   X   X  X X XXX XXXXXX
X   X X  XX        X XXXXXXX   XX  XX X  XX  X   X
XX XX XX   XXXXXXX X XXXX  X XX   XXX XX   X   X X
XX    X  X         X      XX    XXXXX    X XXXXX X
XXXXXXXXXXXXXXXXXXXXXXXXXXXXXXXXXXXXXXXXXXXXXXXXXX
