XXXXXXXXXXXXXXXXXXXXXXXXXXXXXXXXXXXXXXXXXXXXXXXXXXXXXXXXXXXXXXXXXXXXXXXXXXXXXXXXXXXXXXXXXXXXXXXXXXXX
XXXXXXXXXXXXXXXXXXXXXXXXXXXXXXX    XXXXXXXXX X    X       XXXX     X      X XX    X   XXXXXXXXXXXXXX
XXXXXXXXXXXXXXXXXXXXXXXXXXXXXXX XX XXXXXXX   X XXX  X XXX XXX  XXX XX X X X  X XXXX X   XXXXXXXXXXXX
XXXXXXXXXXXXXXXXXXXXXXXXXXXXX   X   XXXXX  XXX   X XX   X     XX X XX XXX   XX XX   XXX XXXXXXXXXXXX
XXXXXXXXXXXXXXXXXXXXXXXXXXXX  XXX X  XX   XXXXXX X  XXX XXXXXXXX X  X X   XXXX    XXX X    XXXXXXXXX
XXXXXXXXXXXXXXXXXXXXXXXXXXXXX X X XX X  X  XXXXX   XX X     XXXX XX   XX XXXXXXXXXXX  XXXX  XXXXXXXX
XXXXXXXXXXXXXXXXXXXXXX    XXX X X  X X XXX  XX   X    XXXXX XXXX XXXXXX  XXXXXXXX    XXXXXX XXXX   X
XXXXXXXXXXXXXXXXXXXXX  XXXXXX X XX X X   XX    XXXXXXXXXXX    X       XX XXXXX    XXXXXXXX     X X X
XXXXXXXXXXXXXXXXXXXX  XXX     X    X XXX XXXXXXXXX     XXX XX X XX XX  X XXX   XX   XXXXXX XXX   X X
XXXXXXXXXXXXXXXXXXXX XXXX XX XXXXX X X X XXX X     XXX  XX XX X    XXX   X   X XXXX  XXXXX X XXXXX X
XXXXXXXXXXXXXXXXXXXX      X  XXXXX X   X  XX   XXXXXXXX  X  X XXXX XXXXXXX X X XXXXX  X    X  X    X
XXXXXXXXXXXXXXXXXXXXXX XXXX XXXXXX XX XXX XXX XXXXXXXXXX XX X   X        XXX X   XX  XX XX X XX XXXX
XXXXXXXXXXXXXXXXXXX    X X  XXXXX XX  X   XX    XXX    X XX XXX X X X XX    XXXX X  XXX  X   XX   XX
XXXXXXXXXXXXXXXXXXXXX X  XXXXXXX     XX XXXX XX  X  X XX  X   X X X X XXXXX XXX  X XXXXX  XXXXXXX  X
XXXXXXXXXXXXXXXXXXXX  X XXXXXXX  XXXX   X    XXX X XX   X XXXXX X X X X   X XX  X  X   XX XX    XX X
XXXXXXXXXXXXXXXXXXXX XX   XXXXX XXX X XXX XXXXXX X  XXX X S   X  XX X   X XXX  XXX   X  X  X XX XX X
XXXXXXXXXXXX    XXXXXXXXX  XXXX       X   XX     XX XXX XXXXX XX X XXXXXXX X  X   XXXXX XX X X   X X
XXXXXXXXXXX  XX XXXXXXXXXX XXXX XXXXXXX XX   X XXX     XXXXXX X       XXXX X XX X XX X     X X X   X
XXXXXXXXXXX XXX   XXXXX         XX    X X  X X X   XXX  XXXXX X XXXXX XXXX X    X  X X XXXXXXX XXXXX
XXXXXXXXXXX    XX   XXX XXXXXXXXXX XX X XXXXXX X XXXXXX  X    X  XXX     X XX XXXX   X  X      XXXXX
XXXXXXXXXXXXXX X  X     X  XX X XX XX   X   X XX       X X XXXXX XXX XXX X XX    XXXXXX  XXXXXXXXXXX
XXXXXXXXXXXXXX XXXX X XXXX    X XX  X XXX X    XXXXXXX X X    X  XXX  XXXX XXXXX XXXXXXX   XX      X
XXXXXXXXXXXXXX   X  X      XXX   X XX X   XXXX XXXXXX  X XX XXX XXXXX X     X    XXXXXXXXX    XXXX X
XXXXXXXXXXXXXXXX X XX XXXXX    XX  XXX  XX     XXX    XX XX XX  XXXX  X XXX   XXX    X    XXXXXXX  X
XXXXXXXXXXXXXXX  X  X   XX  XX  X XX   XX  XXXXXX  XXXXX  X X  XXXXX XX XXXXXXXXX XX X XX XXXXXX  XX
XXXXXXXXXXXXXXX XXX  XX XX XXX XX    XXXX XXXX    X   XXX     XXXXXX X  XXXX XXXX X    XX XXXXXX XXX
XXXXXXXXXX      XXXX  XXX  XXX XXXXX    X XXX  XXXX X    XXXXXXX     X XXX    X   X X X   XXXXXX  XX
XXXXXXXXXX X XXXXXXXX X  XXXXX XXXXXX X X  XX XX XX X XX X   X   XXX X     XX X XXX XXXXXXXXXXXXX  X
XXXXXXXX X XXXXXXXXXX XX XXXX  XXXXXXXX XX X  X   X X  X   X   XXXX    XXXXX  X XXXX   X   XX    X X
XXXXXXXX X   XXXX   X X  XXX  XX   X    X  X XX XXX X XXXXXXXX X    XXXXXXXX XX XXXX XXX X XX XX X X
XXXXXXXX XXX  XXX XXXXX XXX  X   X  XXXXX XX X      XXXXXXXXXX   XX XXXXXXXX XX XXXX X X X X  X  X X
XXXXXXXX X  X XXX        XX XX XXXX XXX X    X XXXX X    XXXXXXXXXX XXXXXXX  X  XXXX   X X XXXX XX X
XXXXXXXX XX X XXXX XXXXX    X     X X X   XXXX    X X XX   XXX       XXXXXX XX XX   XX      XX   X X
XXXXXXXX      XXXXXXXXXXX X   XX XX X XXXXX XXXXX   X XXXX     XXXXX XXXXX   X    X XXXXX X XX XXX X
XXXXXXXXXXXXXXXXXXXXXX    XXXXX  XXXX  XXX  XXXXXXXXX XXXXXXXX X   X    X  X  X XXX X   X X X   X  X
XXXXXXXXXXXX  XXXXXXXX XXXXXXXX XXXXXX XXX XXXXXXX XX  X    X  X X  XXX XXXXX X  X  XXX XXX   X X XX
XXXXXXXXXXXX XXXXXXXX  X XXXXXX  XXXXX XX    XXXX  XXXXX XX XXX  XX XXX   X   XX X XXX    X XXX X XX
XXXXXXXXXXXX XXXXXXXXXXX  XXXXXX  XXXX XX XX  XXX X    X XX  X  X   XX  XXX XXX  X     XX   X X X XX
XXXXXXXXXXX  XXXXXXXXXXXX XXX   X X       XXX XXX X XX X  XX   XX XX   XXX   X  XX XXXXXXXX X   X  X
XXXXXXXXXXX XXXXXXXXXXXXX XXX X X X XXXXXX    XX  X XX  X XXXXXXX X  XXXX  X X XXX  X  X    XXX X XX
XXXXXXXXXXX XXXXXXXXXXXXX     X   X XX XXX XXXX  XX XXX X       X XX X X  XX X XXXX XX   XXXXXXXX XX
XXXXXXXXXXX XXXXXXXXXXXXXXXXXXXXX XXX       XXX XXX X   XXXXX X X XX X X XXX   XXX  XXXXXXXXX   X  X
XXXXXXXXXXX XXXXXXXXXXXXX      XX X   XXXXX XXX XXX XXXXXXXXX X X XX     XXXXXXXXX XXXXXX   X X XX X
XXXXXXXXXXX  XXXXXXXXX   XX XX X    XXXXXXX     XXX  XXXX    XX X XXXXXXX    XXXXX XXXXXX X   X  X X
XXXXXXXXXXXX     XX    X    X  X XXXXXXXXXXXXXXXXXXX X    XX  X X XXX     XX   XXX  X   X XXX XX   X
XXXXXXXXXXXXXXXX XX X XXXXXXXXXX   XXXXXXXXXXXXXXXXX X XXXXXX X X XX  XXXXXXXX    XXX X   X   XXXXXX
XXXXXXXXXXXXXXXX X  X X X XX     XX    XXXXXXXXXXXX  X XXXXX  X X    XXXX   XXXXX     X XXX XXX    X
XXXXXXXXXXXXXXXX   XX      X XXXXXX XX XXXXXXXXXXXX X  XXXXX XXXXXXX     XX    XXXXXXX  XX    X XX X
XXXXXXXXXXXXXXXXX XXXXXXXX X      X  X  XXXXXXXXXXX X XXXXXX       XXXXX   XXX XXXX   X  X XXX   X X
XXXXXXXXXXXXXXXXX     XXXX X XX X  X XX XXXXXXXXXX  X XXXXXXXXXXXXXX   XXX   X X    X XX X   XXX X X
XXXXXXXXXXXXXXXXXXXXX    X X  XXXX X  X XXXXXXX    XX XXXX   XXXXX   X XXXXX     XXXX  X  XXX    X X
XXXXXXXXXXXXXXXXXXXXXXXX   XX    X XX X   XXXXX X XX  XXX  X XXXXX XXX   XXX XXXXXXXXXXXX X   XXX  X
XXXXXXXXXXXXXXXXXXXXXXXXXX  XX X X X  XXX XXXX  X X  XXXX XX XXXXX  XXXX XXX   XXXXXX   X   XXXXX XX
XXXXXXXXXXXXXXXXXXXXXXXXXXX  XXX X   XXXX XXXX X  X XXXXX X  XXXXXX  X   XXX X  XXXXX X XXX XXXXX XX
XXXXXXXXXXXXXXXXXXXXXXXXXXXX   X XXX   X   XX  XX X  X    XXXXXXXXXX  XXXXXX XX XXXX  X  X  XXXX   X
XXXXXXXXXXXXXXXXXXXXXXXXXXXXXX   XXX X X X X  X   XX X XX  XXXXX    X        XX XXXX XXX X XXXXX X X
XXXXXXXXXXXXXXXXXXXXXXXXXXXXX  XXXXX X X X XX X XXXX X  XX    X  XX X XXXX XX   XXX  X X X XXXXX X X
XXXXXXXXXXXXXXXXXXXXXXXXXXXXX XX XX  XXX X X  X   XX XXXX  XX X X   X X    XX X XXX XX X X XXX   X X
XXXXXXXXXXXXXXXXXXXXXXXXXXXXX    X  XX   X   XXXX  X XX X XXX X XXXXX XX X X  X XXX XX X X  X  XXX X
XXXXXXXXXXXXXXXXXXXXXXXXXXXXXXXXXX XX  XXXX XXX XX X      X   X  XXX  XXXX XXXX X   X  X X XX X  X X
XXXXXXXXXXXXXXXXXXXXXXXXXXXXXXX    XX XXX X XX  XX XX XXXXX XXXX XXX X   X XX     XXX XX X XX X XX X
XXXXXXXXXXXXXXXXX    XXXXXXXXXX XXXXX  X  X    XXX  X    X  XXXX XXX X X X XX XXX   X  X X X  X  X X
XXXXXXXXXXXXXXXX  XX XXXXXXXXXX XX   X   XXXX XXXXX X XX XXX   X XXX X X X XX  X XX XX   X X XXX   X
XXXXXXXXXX   X   X   XXXXXXXXX  X  X XXXX   X  XXXX X  X     X   XX  XXX X  XX X XXXXXX XX X XXXXXXX
XXXXXXXXXX X   XXXXX XXXX      XX XX  XXX XXXX  XXX XXXXXXXX XXXXX  XX   XX XX   X   XX XXXX XXX   X
XXXXXXXXXX XXXX      XX   XXXXXXX   X  XX     X  XX   X    X XXXX  X X XX   XX XXX X XX   X  XXX X X
XXXXXXXXXX   XXXX XX    XXX X    XX XX XXXXXX XX   XX X XX   XXX  XX X X  XX   X   X XXXX   XXX  X X
XXXXXXXXXXXXX   X XXXXX      XXX XX XX   XXX     X X  X XXXXXX   XXX X X XXX XX  XXX    XXXX    XXXX
XXXXXXXXXXX   X X XXXXXXXX X X   XX XX X XXX XXXXX XX          XXXX    X XXX  XX    XXX X  X XXX   X
XXXXX       X X   XXXXX XX X   XXXX    X     X    XXXXXXXXXXXX    X XX X XXXX XXXXX  XX XX X X   X X
XXXXX XXXXXXXXXXXX    X    XXXX   XXXX XXXXXXX XX  XXX        XXX X X  X XXXX XXXXXX XX      X X X X
XXXXX   X XX   XX  XX  XXXXXX   X XXXX       X   X     X XXXXXXXX X XX X XXXX  XXXXX XXXXXXX X X X X
XXXXXXX   X  X    XXXX XXX    X X XXXXXXXXXXXX XXXXXXXXXXX    XXX X X    XXXXX XXXXX XXXXX X X   X X
XXXXXX  XXXX XXXXXXXXX XXX XXXX X    XXXX   XX X    XXX    XX XXX XX  XXXXXXXX  XXXX X     X   XXX X
XXXXXX XXX   XXX   XXX XXX XX   X XX XXXX X  X X XX XX  XX X  XX  X  XXXXXXXXXX      X XX XXXXXX   X
XX   X  XX XXX   X XXX     XX XXX  X X    XX   X X  X  XXXXX XXX XX XXXXXXXXXXXX XXXXX  X X    XXX Z
XX XXXX    XX  XXX  X  X XX X XXXX X X XXXXXXX XX  XX X  X   XXX X  XXXXXXXXXXX      X XX   XX   X X
X   XXXXXXXX  X  XX   XX XX X XXXX XXX   X        XXX X XX XX    X XXXXXXXXXXXX X XX   XX XXXXXXX  X
XXX   X      XX XXXXXX    X X X XX   XXXX  XX XXXXXXX X X  X  XXXXXXXXXXXXXXXXX XX X XXX  X       XX
XXXXX X X X X   X      XXXX X X   XX X    XXX   X     X   XX XX    XXXXXXXXXXX  XX X XX  XX XXXXXXXX
XXXXX   X XXX XXXX X XXX  X XXXXX XX   XX   XXXX  XXX XXXXXX  X XX XXXXXXXXX   X     X  XXX XXX    X
XXXXXXXXX      XX  X X XX         XXX XXXXX XX   XX    X     XX X  XXXX  XX  XXXXXXXXXXXXXX XXX XXXX
XXXXXXXXXXXXXX X  XX   XXXXXXX XXXXXX  XXX   X X  X XX X XXX   XX XXXX X XX X    XXX        XXX    X
XXXXXXXXX  X   XX X XXXX     X X    XX XXX XXX XX   XX X    XX XX XXXX X XX XXXX XXX X XXXXXXXXXXX X
XXXXXXXXXX XXX  X X    XXXXX X XX X X  X X X   X  XXXX XXXX XX    XXXX   XX   XX XX  X  X XX     X X
XXXXXXXXXX  XXX X XXXX  X      XXXX X XX X   XXX XX  X      XX XXXXXXXXX   XX    XX XXX   X  XXX X X
XXXXXXXXXXX     X     X   X XXXXX   X  X XXXXXXX  X XXXXXXX X  XXXXXXX XXX XXX XXXX   X XX  XXX  X X
XXXXXXXXXXXXXXXXXXXXXXXXXXX    XX X XXXX XX     X   X    XX X XXXXXXX      X   XXXXXX XXXX XXX  XX X
XXXXXX  XXXXXXXXXXXX   XXXXXXX    X X    X  X X XXXX  XX  X X XXXXXXX XXX XXXXXXXXXXX   XX   X XX  X
XXXXX  XXXXXXXXXXXX  XXXXXXXXX XXXX   XXX  XXXX  X   X XX     XXXXXXX   X    XXXXXXXXXX  XXX XXXX XX
XXXXX XXXXXXXXX     XX X   XXX XXX XX  XX XX   X   XXX XXXXXXXXXXXX   XX  XX XXXXXXXXXX XX X X    XX
XXXX  XXXXXXX   XXX  X X X   X   X XXX  X    X XXX     X     XXXX   XXXX XXX XXXXXXXXXX XX X X XXXXX
XXXX XXXXXXX  XXXXXX     XXX X X X XXXXXXXXXXX XX  XXXX  XXX XXXX XXXXXX  XX XXXXXXXXXX  X X X XXXXX
X    XXXXXXX XXXXXXXXXXXXXXX X X   XXX       X XX XX    XXXX  X   XXXXXXX XXXXXXXXXXXXXX X   X   XXX
X X XXXXXXX  XXXXXXXX      X    XXX X  XXX X   XX  XX XX XXXX   XXXXXXXXX  XXXXXXXXXXXXX  XX XXX  XX
X X   XXXXXXXXX XXXXXXXXXX XXXX XX   X   X XXXXXX X       XXXX XX    XXXXXXXXXXXXXXXXXXXX XX   XX  X
XXX X  XX XXXXX     XXX    XXX  XX X XXX X XXX  X XXXXXXX XXXX XX XXXXXXXXXXXXXXXXXXXXXXX  XXX X X X
XX  XX  X XXXX  XXX     XXXXXX XXX X X X X XX  XX  X   XX XXXX  X    XXXXXXXXXXXXXXXXXXXXX  XX X X X
XXXXXXX        XXXXXXXX            X     X    XXXX   X    XXXXX   XX   XXXXXXXXXXXXXXXXXXXX        X
XXXXXXXXXXXXXXXXXXXXXXXXXXXXXXXXXXXXXXXXXXXXXXXXXXXXXXXXXXXXXXXXXXXXXXXXXXXXXXXXXXXXXXXXXXXXXXXXXXXX
