XXXXXXXXXX
X        Z
X XX XXX X
X  X X XXX
XX X X   X
XX X   X X
X  XXXXX X
X XXS    X
X   XXX XX
XXXXXXXXXX
